46 47 47 47 47 47 47 47 47 47 47 47 47 47 47 47 47 47 47 48 50 56 49
10 35 33 33 33 33 33 33 33 33 33 33 33 33 33 33 33 33 33 33 51 45 52
10 31 26 26 26 26 26 26 26 26 26 26 26 26 26 26 26 26 26 57 51 45 52
10 31 26 27 28 28 28 28 28 28 28 28 28 28 28 28 28 28 28 28 51 45 52
10 31 26 25 33 33 33 33 33 33 33 33 33 33 33 33 33 33 36 10 51 45 52
10 31 26 42 26 26 26 26 26 26 26 26 26 26 26 26 26 26 30 10 51 45 52
11 31 26 42 26 27 28 28 28 28 28 28 28 28 28 28 29 26 30 11 51 45 52
10 31 26 42 26 30 10 10 11 10 10 10 10 10 11 10 31 26 30 10 51 45 52
10 31 26 42 26 30 35 33 33 33 33 33 33 33 33 33 34 26 30 10 51 45 52
10 31 26 42 26 30 31 26 26 26 26 26 26 26 26 26 26 26 30 10 51 45 52
10 31 26 42 26 30 31 26 27 28 28 28 28 28 28 28 28 28 38 10 51 45 52
10 31 26 42 26 30 31 26 30 10 10 10 10 10 10 10 10 10 10 11 51 45 52
10 31 26 43 26 30 31 26 32 33 33 33 33 33 33 33 33 33 33 33 51 45 52
11 31 26 26 26 30 31 26 26 26 26 26 26 26 26 26 26 26 26 58 51 45 52
10 37 28 28 28 38 37 28 28 28 28 28 28 28 28 28 28 28 28 28 53 55 54